####################
#                  #
#    #             #
#    #             #
#    #######       #
#          #       #
#          #       #
#          #       #
#          ####   ##
#                  #
#                  #
#    #######       #
#    #     #       #
#    #     #       #
#  ##### ######  ###
#  #      #        #
#         #        #
#         #        #
#  #      #        #
#  #               #
#  #               #
#  #               #
#  ####            #
#                  #
#         #        #
#         #        #
#         #        #
#         #        #
####################