####################
#                  #
#    #             #
#    #             #
#   ##             #
#    #             #
#    #             #
#    #             #
#          ####   ##
#          #       #
#          #       #
#          #       #
#    #     #       #
#    #     #       #
#  #########       #
#  #      #        #
#         #        #
#         #        #
#  #      #        #
#  #               #
#  #               #
#  ####            #
#  #               #
#  #               #
#                  #
#  #### ###        #
#  #      #        #
#  #      #        #
####################